
Le projet consiste à analyser les crypto-monnaies existait et d'aprés cette analyse on a choisis le type bitcoin pour prédir son prix (time series problem) 

STEP 1  : Analysis_of_Cryptocurrency2


STEP 2  : Bitcoin price prediction









#####################Description des données#######################

Croissance annuelle du hachage : Croissance du nombre total de calculs du réseau au cours des 365 derniers jours.

Hauteur des blocs : Le nombre total de blocs dans la blockchain

Intervalle entre les blocs : Délai moyen entre les blocs

Taille du bloc : La taille de stockage de chaque bloc (en mégaoctets).

Taille de la chaîne de blocs : La taille de stockage de la chaîne de blocs (en gigaoctets).

Blocs quotidiens : Nombre de blocs trouvés chaque jour

Densité de la valeur de la chaîne : La valeur de la blockchain du bitcoin, en termes de dollars par mégaoctet

Transactions quotidiennes : Le nombre de transactions incluses dans la blockchain par jour.

Difficulté : Le seuil minimum de preuve de travail requis pour qu'un mineur de bitcoin puisse extraire un bloc.

Pourcentage de frais : Frais moyens payés en pourcentage du volume de transactions
Taux de frais : Frais moyens payés par transaction

Croissance des hachages sur deux semaines : Croissance du nombre total de calculs du réseau au cours des 14 derniers jours.

Taux de hachage : Le nombre de solutions de blocs calculées par seconde par tous les mineurs.

Capitalisation du marché : La valeur marchande de tous les bitcoins en circulation.

Loi de Metcalfe - TX : Une variante de la loi de Metcalfe dans laquelle le prix est divisé par le nombre n log n de transactions quotidiennes.

Loi de Metcalfe - UTXO : Une variante de la loi de Metcalfe dans laquelle le prix est divisé par n log n nombre de sorties de transactions non dépensées

Valeur du revenu du mineur : Le montant des dollars gagnés par le réseau minier

Revenu du mineur : Le montant de bitcoins gagné par le réseau minier, sous la forme de récompenses de blocs et de frais de transaction.

Masse monétaire : La quantité de bitcoins en circulation

Valeur de sortie : La valeur en dollars de toutes les sorties envoyées sur le réseau.

Volume de sortie : La quantité de bitcoins envoyés sur le réseau.

Prix du bitcoin : La valeur en dollars d'un bitcoin.

Croissance trimestrielle des hachages : Croissance du nombre total de calculs du réseau tions du réseau au cours des 90 derniers jours

Transactions totales : Le nombre total de transactions traitées par le réseau Bitcoin.

Montant des transactions : Le montant moyen de bitcoins déplacés par transaction.

Valeur des frais : La valeur en dollars des frais de minage

Frais de transaction : Le montant de bitcoin payé aux mineurs en frais de transaction.

Taille de la transaction : La taille moyenne des données d'une transaction

Valeur de la transaction : La valeur moyenne en dollars déplacée dans chaque transaction

Transactions par bloc : Le nombre de transactions dans chaque bloc

Montant moyen des UTXO : Le montant moyen de bitcoin contenu dans chaque sortie de transaction non dépensée

Croissance UTXO : Le nombre net de sorties de transactions non dépensées créées

UTXO Set Size : Le nombre total de sorties de transactions non dépensées

Valeur moyenne des UTXO : La valeur moyenne en dollars de chaque sortie de transaction non dépensée.

Velocity - Daily : La proportion de la masse monétaire transigée chaque jour.

Vélocité - Trimestrielle : La proportion de la masse monétaire transigée chaque jour, calculée sur une base trimestrielle mobile.

Vélocité de la monnaie : Combien de fois la masse monétaire change de mains au cours d'une année donnée.

